tempat: place

rumah: house
rumah kos: boarding house
ruang makan: dining room
dapur: kitchen
kamar kecil: restroom

jalan: street
sekolah: school
aparteman: apartment
bioskop: movie theater
cafe: cafe
pasar: market

kantin: canteen
kantor: office
kantor pos: post office

negara: country
asing: foreign
Irlandia: Ireland
Uganda: Uganda
Inggris: England
Jepang: Japan
Jerman: Germany
Korea: Korea
Perancis: France
Amerika: America
Amerika Serikat: USA

warganegara: citizen
visa: visa

negara bagian: state
ibu kota: capital city
kota: city
desa: village
gunung: mountain
sungai: river
